Slug Maze
Used for testing the slug pathfinding.
7
##################
#B#......##$....B#
#.#.###.###..#.###
#.S.#...#...##...#
#.#.#...#...#....#
#...#B...._.#...@#
##################
v
v
<
>
0