Intro Map
Never played before? This one is for you!
7
##################
#_.........$.....#
#................#
#S...............#
#............$...#
#...............@#
##################
>
0