So Many Skeletons
A fun puzzle :) Good luck!
13
######################
#.........S.........S#
#....S........S......#
#........S........S..#
#...S........S.......#
#.......S........S...#
#..S........S........#
#......S........S....#
#.S........S.........#
#.....S...Z....S...$.#
#.####################
#@.................._#
######################
v
v
^
v
^
v
^
v
v
v
v
^
v
v
v
v
^
<
^
0