Shadow Test Map
Map designed to experiment with the effects of shadows and what is visible.
11
######################
#.._.................#
#....................#
#....................#
#....................#
#.........#..........#
#..#.................#
#....................#
#....................#
#@........Z........$.#
######################
>
0